{
	"biomes" :
		[
			{
				"label"  : "w0",
				"name" : "Open Ocean",
				"food_spawn_percentage" : 0,
				"food_energy_amount" : 0,
				"food_energy_growth_amount" : 0,
				"movement_resistance" : 1,
				"food_intensity" : 1,
				"tile_intensity" : 1,
				"color_red" : 0,
				"color_green" : 0,
				"color_blue" : 255
			},
			{
				"label"  : "w1",
				"name" : "Shallow Water",
				"food_spawn_percentage" : 0.4,
				"food_energy_amount" : 1,
				"food_energy_growth_amount" : 0.025,
				"movement_resistance" : 0.01,
				"food_intensity" : 1,
				"tile_intensity" : 0.5,
				"color_red" : 0,
				"color_green" : 180,
				"color_blue" : 255
			},
			{
				"label"  : "l0",
				"name" : "Land",
				"food_spawn_percentage" : 0.2,
				"food_energy_amount" : 1,
				"food_energy_growth_amount" : 0.025,
				"movement_resistance" : 0.0,
				"food_intensity" : 1,
				"tile_intensity" : 0.5,
				"color_red" : 255,
				"color_green" : 201,
				"color_blue" : 14
			},
			{
				"label"  : "l1",
				"name" : "Grassland",
				"food_spawn_percentage" : 0.2,
				"food_energy_amount" : 1,
				"food_energy_growth_amount" : 0.025,
				"movement_resistance" : 0.0,
				"food_intensity" : 1,
				"tile_intensity" : 0.5,
				"color_red" : 180,
				"color_green" : 230,
				"color_blue" : 40
			},
			{
				"label"  : "l2",
				"name" : "Hell",
				"food_spawn_percentage" : 0.15,
				"food_energy_amount" : 1,
				"food_energy_growth_amount" : 0.035,
				"movement_resistance" : 0.0,
				"food_intensity" : 1,
				"tile_intensity" : 0.5,
				"color_red" : 240,
				"color_green" : 40,
				"color_blue" : 40
			},
			{
				"label"  : "l3",
				"name" : "Fertile Crescent",
				"food_spawn_percentage" : 0.25,
				"food_energy_amount" : 1,
				"food_energy_growth_amount" : 0.1,
				"movement_resistance" : 0.0,
				"food_intensity" : 1,
				"tile_intensity" : 0.5,
				"color_red" : 100,
				"color_green" : 255,
				"color_blue" : 255
			}
		],
	"tiles" :
		[
			"l0l0l0l0l0l0l0l0l0l0l0l0l0l0l0l0l0l0l0l0l0l0l0l0l0l0l0l0l0l1l1l1l1l1l1l1l1l1l1l1l1l1l1l1l1l1l1l1l1l1l1l1l0l0l0l0l0l0l0l0l0l0l0l0l0l0l0l0l0l0l0l0l0l0l0l0l0l0l0l0l0l0l0l0l0l0l0l0l0l0l0l0l0l0l0l0l0l0l0l0",
			"l0l0l0l0l0l0l0l0l0l0l0l0l0l0l0l0l0l0l0l0l0l0l0l0l0l0l0l0l0l1l1l1l1l1l1l1l1l1l1l1l1l1l1l1l1l1l1l1l1l1l1l1l0l0l0l0l0l0l0l0l0l0l0l0l0l0l0l0l0l0l0l0l0l0l0l0l0l0l0l0l0l0l0l0l0l0l0l0l0l0l0l0l0l0l0l0l0l0l0l0",
			"l0l0l0l0l0l0l0l0l0l0l0l0l0l0l0l0l0l0l0l0l0l0l0l0l0l0l0l0l0l1l1l1l1l1l1l1l1l1l1l1l1l1l1l1l1l1l1l1l1l1l1l1l0l0l0l0l0l0l0l0l0l0l0l0l0l0l0l0l0l0l0l0l0l0l0l0l0l0l0l0l0l0l0l0l2l2l2l2l2l2l2l2l2l2l0l0l0l0l0l0",
			"l0l0l0l0l0l0l0l0l0l0l0l0l0l0l0l0l0l0l0l0l0l0l0l0l0l0l0l0l0l1l1l1l1l1l1l1l1l1l1l1l1l1l1l1l1l1l1l1l1l1l1l1l0l0l0l0l0l0l0l0l0l0l0l0l0l0l0l0l0l0l0l0l0l0l0l0l0l0l0l0l0l0l0l0l2l2l2l2l2l2l2l2l2l2l0l0l0l0l0l0",
			"l0l0l0l0l0l0l0l0l0l0l0l0l0l0l0l0l0l0l0l0l0l0l0l0l0l0l0l0l0l1l1l1l1l1l1l1l1l1l1l1l1l1l1l1l1l1l1l1l1l1l1l1l0l0l0l0l0l0l0l0l0l0l0l0l0l0l0l0l0l0l0l0l0l0l0l0l0l0l0l0l0l0l0l0l2l2l2l2l2l2l2l2l2l2l0l0l0l0l0l0",
			"l0l0l0l0l0l0l0l0l0l0l0l0l0l0l0l0l0l0l0l0l0l0l0l0l0l0l0l0l0l1l1l1l1l1l1l1l1l1l1l1l1l1l1l1l1l1l1l1l1l1l1l1l0l0l0l0l0l0l0l0l0l0l0l0l0l0l0l0l0l0l0l0l0l0l0l0l0l0l0l0l0l0l0l0l2l2l2l2l2l2l2l2l2l2l0l0l0l0l0l0",
			"l0l0l0l0l0l0l0l0l0l0l0l0l0l0l0l0l0l0l0l0l0l0l0l0l0l0l0l0l0l1l1l1l1l1l1l1l1l1l1l1l1l1l1l1l1l1l1l1l1l1l1l1l0l0l0l0l0l0l0l0l0l0l0l0l0l0l0l0l0l0l0l0l0l0l0l0l0l0l0l0l0l0l0l0l2l2l2l2l2l2l2l2l2l2l0l0l0l0l0l0",
			"l0l0l0l0l0l0l0l0l0l0l0l0l0l0l0l0l0l0l0l0l0l0l0l0l0l0l0l0l0l1l1l1l1l1l1l1l1l1l1l1l1l1l1l1l1l1l1l1l1l1l1l1l0l0l0l0l0l0l0l0l0l0l0l0l0l0l0l0l0l0l0l0l0l0l0l0l0l0l0l0l0l0l0l0l2l2l2l2l2l2l2l2l2l2l0l0l0l0l0l0",
			"l0l0l0l0l0l0l0l0l0l0l0l0l0l0l0l0l0l0l0l0l0l0l0l0l0l0l0l0l0l1l1l1l1l1l1l1l1l1l1l1l1l1l1l1l1l1l1l1l1l1l1l1l0l0l0l0l0l0l0l0l0l0l0l0l0l0l0l0l0l0l0l0l0l0l0l0l0l0l0l0l0l0l0l0l2l2l2l2l2l2l2l2l2l2l0l0l0l0l0l0",
			"l0l0l0l0l0l0l0l0l0l0l0l0l0l0l0l0l0l0l0l0l0l0l0l0l0l0l0l0l0l1l1l1l1l1l1l1l1l1l1l1l1l1l1l1l1l1l1l1l1l1l1l1l0l0l0l0l0l0l0l0l0l0l0l0l0l0l0l0l0l0l0l0l0l0l0l0l0l0l0l0l0l0l0l0l0l0l0l0l0l0l0l0l0l0l0l0l0l0l0l0",
			"l0l0l0l0l0l0l0l0l0l0l0l0l0l0l0l0l0l0l0l0l0l0l0l0l0l0l0l0l0l1l1l1l1l1l1l1l1l1l1l1l1l1l1l1l1l1l1l1l1l1l1l1l0l0l0l0l0l0l0l0l0l0l0l0l0l0l0l0l0l0l0l0l0l0l0l0l0l0l0l0l0l0l0l0l0l0l0l0l0l0l0l0l0l0l0l0l0l0l0l0",
			"l0l0l0l0l0l0l0l0l0l0l0l0l0l0l0l0l0l0l0l0l0l0l0l0l0l0l0l0l0l1l1l1l1l1l1l1l1l1l1l1l1l1l1l1l1l1l1l1l1l1l1l1l0l0l0l0l0l0l0l0l0l0l0l0l0l0l0l0l0l0l0l0l0l0l0l0l0l0l0l0l0l0l0l0l0l0l0l0l0l0l0l0l0l0l0l0l0l0l0l0",
			"l0l0l0l0l0l0l0l0l0l0l0l0l0l0l0l0l0l0l0l0l0l0l0l0l0l0l0l0l0l1l1l1l1l1l1l1l1l1l1l1l1l1l1l1l1l1l1l1l1l1l1l1l0l0l0l0l0l0l0l0l0l0l0l0l0l0l0l0l0l0l0l0l0l0l0l0l0l0l0l0l0l0l0l0l0l0l0l0l0l0l0l0l0l0l0l0l0l0l0l0",
			"l0l0l0l0l0l0l0l0l0l0l0l0l0l0l0l0l0l0l0l0l0l0l0l0l0l0l0l0l0l1l1l1l1l1l1l1l1l1l1l1l1l1l1l1l1l1l1l1l1l1l1l1l0l0l0l0l0l0l0l0l0l0l0l0l0l0l0l0l0l0l0l0l0l0l0l0l0l0l0l0l0l0l0l0l0l0l0l0l0l0l0l0l0l0l0l0l0l0l0l0",
			"l0l0l0l0l0l0l0l0l0l0l0l0l0l0l0l0l0l0l0l0l0l0l0l0l0l0l0l0l0l1l1l1l1l1l1l1l1l1l1l1l1l1l1l1l1l1l1l1l1l1l1l1l0l0l0l0l0l0l0l0l0l0l0l0l0l0l0l0l0l0l0l0l0l0l0l0l0l0l0l0l0l0l0l0l0l0l0l0l0l0l0l0l0l0l0l0l0l0l0l0",
			"l0l0l0l0l0l0l0l0l0l0l0l0l0l0l0l0l0l0l0l0l0l0l0l0l0l0l0l0l0l1l1l1l1l1l1l1l1l1l1l1l1l1l1l1l1l1l1l1l1l1l1l1l0l0l0l0l0l0l0l0l0l0l0l0l0l0l0l0l0l0l0l0l0l0l0l0l0l0l0l0l0l0l0l0l0l0l0l0l0l0l0l0l0l0l0l0l0l0l0l0",
			"l0l0l0l0l0l0l0l0l0l0l0l0l0l0l0l0l0l0l0l0l0l0l0l0l0l0l0l0l0l1l1l1l1l1l1l1l1l1l1l1l1l1l1l1l1l1l1l1l1l1l1l1l0l0l0l0l0l0l0l0l0l0l0l0l0l0l0l0l0l0l0l0l2l2l2l2l2l2l2l2l2l2l2l2l0l0l0l0l0l0l0l0l0l0l0l0l0l0l0l0",
			"l0l0l0l0l0l0l0l0l0l0l0l0l0l0l0l0w0w0w0w0w0w0w0w0l3l3l3l3l3l3l3l3l0w0w0w0w0w0w0w0w0w0w0w0w0w0w0w0w0w0w0w0l0l0l0l0l0l0l0l0l0l0l0l0l0l0l0l0l0l0l0l0l2l2l2l2l2l2l2l2l2l2l2l2l0l0l0l0l0l0l0l0l0l0l0l0l0l0l0l0",
			"l0l0l0l0l0l0l0l0l0l0l0l0l0l0l0l0w0w0w0w0w0w0w0w0l3l3l3l3l3l3l3l3l0w0w0w0w0w0w0w0w0w0w0w0w0w0w0w0w0w0w0w0l0l0l0l0l0l0l0l0l0l0l0l0l0l0l0l0l0l0l0l0l2l2l2l2l2l2l2l2l2l2l2l2l0l0l0l0l0l0l0l0l0l0l0l0l0l0l0l0",
			"l0l0l0l0l0l0l0l0l0l0l0l0l0l0l0l0w0w0w0w0w0w0w0w0l3l3l3l3l3l3l3l3l0w0w0w0w0w0w0w0w0w0w0w0w0w0w0w0w0w0w0w0l0l0l0l0l0l0l0l0l0l0l0l0l0l0l0l0l0l0l0l0l2l2l2l2l2l2l2l2l2l2l2l2l0l0l0l0l0l0l0l0l0l0l0l0l0l0l0l0",
			"l0l0l0l0l0l0l0l0l0l0l0l0l0l0l0l0w0w0w0w0w0w0w0w0l3l3l3l3l3l3l3l3l0w0w0w0w0w0w0w0w0w0w0w0w0w0w0w0w0w0w0w0l0l0l0l0l0l0l0l0l0l0l0l0l0l0l0l0l0l0l0l0l2l2l2l2l2l2l2l2l2l2l2l2l0l0l0l0l0l0l0l0l0l0l0l0l0l0l0l0",
			"l0l0l0l0l0l0l0l0l0l0l0l0l0l0l0l0w0w0w0w0w0w0w0w0l3l3l3l3l3l3l3l3l0w0w0w0w0w0w0w0w0w0w0w0w0w0w0w0w0w0w0w0l0l0l0l0l0l0l2l2l2l2l2l2l2l2l2l2l2l2l2l2l2l2l2l2l2l2l2l2l2l2l2l2l0l0l0l0l0l0l0l0l0l0l0l0l0l0l0l0",
			"l0l0l0l0l0l0l0l0l0l0l0l0l0l0l0l0w0w0w0w0w0w0w0w0l3l3l3l3l3l3l3l3l0w0w0w0w0w0w0w0w0w0w0w0w0w0w0w0w0w0w0w0l0l0l0l0l0l0l2l2l2l2l2l2l2l2l2l2l2l2l2l2l2l2l2l2l2l2l2l2l2l2l2l2l0l0l0l0l0l0l0l0l0l0l0l0l0l0l0l0",
			"l0l0l0l0l0l0l0l0l0l0l0l0l0l0l0l0w0w0w0w0w0w0w0w0l3l3l3l3l3l3l3l3l0w0w0w0w0w0w0w0w0w0w0w0w0w0w0w0w0w0w0w0l0l0l0l0l0l0l2l2l2l2l2l2l2l2l2l2l2l2l2l2l0l0l0l0l0l0l0l0l0l0l0l0l0l0l0l0l0l0l0l0l0l0l0l0l0l0l0l0",
			"l0l0l0l0l0l0l0l0l0l0l0l0l0l0l0l0w0w0w0w0w0w0w0w0l3l3l3l3l3l3l3l3l0w0w0w0w0w0w0w0w0w0w0w0w0w0w0w0w0w0w0w0l0l0l0l0l0l0l2l2l2l2l2l2l2l2l2l2l2l2l2l2l0l0l0l0l0l0l0l0l0l0l0l0l0l0l0l0l0l0l0l0l0l0l0l0l0l0l0l0",
			"l0l0l0l0l0l0l0l0l0l0l0l0l0l0l0l0w0w0w0w0w0w0w0w0l3l3l3l3l3l3l3l3l0w0w0w0w0w0w0w0w0w0w0w0w0w0w0w0w0w0w0w0l0l0l0l0l0l0l2l2l2l2l2l2l2l2l2l2l2l2l2l2l0l0l0l0l0l0l0l0l0l0l0l0l0l0l0l0l0l0l0l0l0l0l0l0l0l0l0l0",
			"l0l0l0l0l0l0l0l0l0l0l0l0l0l0l0l0w0w0w0w0w0w0w0w0l3l3l3l3l3l3l3l3l0w0w0w0w0w0w0w0w0w0w0w0w0w0w0w0w0w0w0w0l0l0l0l0l0l0l2l2l2l2l2l2l2l2l2l2l2l2l2l2l0l0l0l0l0l0l0l0l0l0l0l0l0l0l0l0l0l0l0l0l0l0l0l0l0l0l0l0",
			"l0l0l0l0l0l0l0l0l0l0l0l0l0l0l0l0w0w0w0w0w0w0w0w0l3l3l3l3l3l3l3l3l0w0w0w0w0w0w0w0w0w0w0w0w0w0w0w0w0w0w0w0l0l0l0l0l0l0l2l2l2l2l2l2l2l2l2l2l2l2l2l2l0l0l0l0l0l0l0l0l0l0l0l0l0l0l0l0l0l0l0l0l0l0l0l0l0l0l0l0",
			"l0l0l0l0l0l0l0l0l0l0l0l0l0l0l0l0w0w0w0w0w0w0l3l3l3l3l3l3l3l3l3l3l3l3l3l3l3l3l3l3l3l3l3w0w0w0w0w0w0w0w0w0l0l0l0l0l0l0l0l0l0l0l0l0l0l0l0l0l0l0l0l0l0l0l0l0l0l0l0l0l0l0l0l0l0l0l0l0l0l0l0l0l0l0l0l0l0l0l0l0",
			"l0l0l0l0l0l0l0l0l0l0l0l0l0l0l0l0w0w0w0w0w0w0l3l3l3l3l3l3l3l3l3l3l3l3l3l3l3l3l3l3l3l3l3w0w0w0w0w0w0w0w0w0l0l0l0l0l0l0l0l0l0l0l0l0l0l0l0l0l0l0l0l0l0l0l0l0l0l0l0l0l0l0l0l0l2l2l2l2l2l2l2l2l2l2l0l0l0l0l0l0",
			"l0l0l0l0l0l0l0l0l0l0l0l0l0l0l0l0w0w0w0w0w0w0l3l3l3l3l3l3l3l3l3l3l3l3l3l3l3l3l3l3l3l3l3w0w0w0w0w0w0w0w0w0l0l0l0l0l0l0l0l0l0l0l0l0l0l0l0l0l0l0l0l0l0l0l0l0l0l0l0l0l0l0l0l0l2l2l2l2l2l2l2l2l2l2l0l0l0l0l0l0",
			"l0l0l0l0l0l0l0l0l0l0l0l0l0l0l0l0w0w0w0w0w0w0l3l3l3l3l3l3l3l3l3l3l3l3l3l3l3l3l3l3l3l3l3w0w0w0w0w0w0w0w0w0l0l0l0l0l0l0l0l0l0l0l0l0l0l0l0l0l0l0l0l0l0l0l0l0l0l0l0l0l0l0l0l0l2l2l2l2l2l2l2l2l2l2l0l0l0l0l0l0",
			"l0l0l0l0l0l0l0l0l0l0l0l0l0l0l0l0w0w0w0w0w0w0l3l3l3l3l3l3l3l3l3l3l3l3l3l3l3l3l3l3l3l3l3w0w0w0w0w0w0w0w0w0l0l0l0l0l0l0l0l0l0l0l0l0l0l0l0l0l0l0l0l0l0l0l0l0l0l0l0l0l0l0l0l0l2l2l2l2l2l2l2l2l2l2l0l0l0l0l0l0",
			"l0l0l0l0l0l0l0l0l0l0l0l0l0l0l0l0w0w0w0w0w0w0l3l3l3l3l3l3l3l3l3l3l3l3l3l3l3l3l3l3l3l3l3w0w0w0w0w0w0w0w0w0l0l0l0l0l0l0l0l0l0l0l0l0l0l0l0l0l0l0l0l0l0l0l0l0l0l0l0l0l0l0l0l0l2l2l2l2l2l2l2l2l2l2l0l0l0l0l0l0",
			"l0l0l0l0l0l0l0l0l0l0l0l0l0l0l0l0w0w0w0w0w0w0l3l3l3l3l3l3l3l3l3l3l3l3l3l3l3l3l3l3l3l3l3w0w0w0w0w0w0w0w0w0l0l0l0l0l0l0l0l0l0l0l0l0l0l0l0l0l0l0l0l0l0l0l0l0l0l0l0l0l0l0l0l0l2l2l2l2l2l2l2l2l2l2l0l0l0l0l0l0",
			"l0l0l0l0l0l0l0l0l0l0l0l0l0l0l0l0w0w0w0w0w0w0l3l3l3l3l3l3l3l3l3l3l3l3l3l3l3l3l3l3l3l3l3w0w0w0w0w0w0w0w0w0l0l0l0l0l0l0l0l0l0l0l0l0l0l0l0l0l0l0l0l0l0l0l0l0l0l0l0l0l0l0l0l0l2l2l2l2l2l2l2l2l2l2l0l0l0l0l0l0",
			"l0l0l0l0l0l0l0l0l0l0l0l0l0l0l0l0w0w0w0w0w0w0l3l3l3l3l3l3l3l3l3l3l3l3l3l3l3l3l3l3l3l3l3w0w0w0w0w0w0w0w0w0l0l0l0l0l0l0l0l0l0l0l0l0l0l0l0l0l0l0l0l0l0l0l0l0l0l0l0l0l0l0l0l0l0l0l0l0l0l0l0l0l0l0l0l0l0l0l0l0",
			"l0l0l0l0l0l0l0l0l0l0l0l0l0l0l0l0w0w0w0w0w0w0l3l3l3l3l3l3l3l3l3l3l3l3l3l3l3l3l3l3l3l3l3w0w0w0w0w0w0w0w0w0l0l0l0l0l0l0l0l0l0l0l0l0l0l0l0l0l0l0l0l0l0l0l0l0l0l0l0l0l0l0l0l0l0l0l0l0l0l0l0l0l0l0l0l0l0l0l0l0",
			"l0l0l0l0l0l0l0l0l0l0l0l0l0l0l0l0w0w0w0w0w0w0l3l3l3l3l3l3l3l3l3l3l3l3l3l3l3l3l3l3l3l3l3w0w0w0w0w0w0w0w0w0l0l0l0l0l0l0l0l0l0l0l0l0l0l0l0l0l0l0l0l0l0l0l0l0l0l0l0l0l0l0l0l0l0l0l0l0l0l0l0l0l0l0l0l0l0l0l0l0",
			"l0l0l0l0l0l0l0l0l0l0l0l0l0l0l0l0w0w0w0w0w0w0w0w0w0w0w0w0w0w0w0w0w0w0w0w0w0w0w0w0w0w0w0w0w0w0w0w0w0w0w0w0l0l0l0l0l0l0l0l0l0l0l0l0l0l0l0l0l0l0l0l0l0l0l0l0l0l0l0l0l0l0l0l0l0l0l0l0l0l0l0l0l0l0l0l0l0l0l0l0",
			"l0l0l0l0l0l0l0l0l0l0l0l0w0w0w0w0w0w0w0w0w0w0w0w0w0w0w0w0w0w0w0w0w0w0w0w0w0w0w0w0w0w0w0w0w0w0w0w0w0w0w0w0l0l0l0l0l0l0l0l0l0l0l0l0l0l0l0l0l0l0l0l0l0l0l0l0l0l0l0l0l0l0l0l0l0l0l0l0l0l0l0l0l0l0l0l0l0l0l0l0",
			"w1w1w1w1w1w1w1w1w1w1w1w1w0w0w0w0w0w0w0w0w0w0w0w0w0w0w0w0w0w0w0w0w0w0w0w0w0w0w0w0w0w0w0w0w0w0w0w0w0w0w0w0l1l1l1l1l1l1l1l1l1l1l1l1l1l1l1l1l1l1l1l1l1l1l0l0l0l0l0l0l0l0l0l0l0l0l0l0l0l0l0l0l0l0l0l0l0l0l0l0",
			"w1w1w1w1w1w1w1w1w1w1w1w1w0w0w0w0w0w0w0w0w0w0w0w0w0w0w0w0w0w0w0w0w0w0w0w0w0w0w0w0w0w0w0w0w0w0w0w0w0w0w0w0l1l1l1l1l1l1l1l1l1l1l1l1l1l1l1l1l1l1l1l1l1l1l0l0l0l0l0l0l0l0l0l0l0l0l0l0l0l0l0l0l0l0l0l0l0l0l0l0",
			"w1w1w1w1w1w1w1w1w1w1w1w1w0w0w0w0w0w0w0w0w0w0w0w0w0w0w0w0w0w0w0w0w0w0w0w0w0w0w0w0w0w0w0w0w0w0w0w0w0w0w0w0l1l1l1l1l1l1l1l1l1l1l1l1l1l1l1l1l1l1l1l1l1l1l0l0l0l0l0l0l0l0l0l0l0l0l0l0l0l0l0l0l0l0l0l0l0l0l0l0",
			"w1w1w1w1w1w1w1w1w1w1w1w1w0w0w0w0w0w0w0w0w0w0w0w0w0w0w0w0w0w0w0w0w0w0w0w0w0w0w0w0w0w0w0w0w0w0w0w0w0w0w0w0l1l1l1l1l1l1l1l1l1l1l1l1l1l1l1l1l1l1l1l1l1l1l0l0l0l0l0l0l0l0l0l0l0l0l0l0l0l0l0l0l0l0l0l0l0l0l0l0",
			"w1w1w1w1w1w1w1w1w1w1w1w1w1w1w1w1w1w1w1w1w1w1w1w1w1w1w1w1w1w1w1w0w0w0w0w0w0w0w0w0w0w0w0w0w0w0w0w0w0w0w0w0l1l1l1l1l1l1l1l1l1l1l1l1l1l1l1l1l1l1l1l1l1l1l0l0l0l0l0l0l0l0l0l0l0l0l0l0l0l0l0l0l0l0l0l0l0l0l0l0",
			"w1w1w1w1w1w1w1w1w1w1w1w1w1w1w1w1w1w1w1w1w1w1w1w1w1w1w1w1w1w1w1l1l1l1l1l1l1l1l1l1l1l1l1l1l1l1l1l1l1l1l1l1l1l1l1l1l1l1l1l1l1l1l1l1l1l1l1l1l1l1l1l1l1l1l0l0l0l0l0l0l0l0l0l0l0l0l0l0l0l0l0l0l0l0l0l0l0l0l0l0",
			"w1w1w1w1w1w1w1w1w1w1w1w1w1w1w1w1w1w1w1w1w1w1w1w1w1w1w1w1w1w1w1l1l1l1l1l1l1l1l1l1l1l1l1l1l1l1l1l1l1l1l1l1l1l1l1l1l1l1l1l1l1l1l1l1l1l1l1l1l1l1l1l1l1l1l0l0l0l0l0l0l0l0l0l0l0l0l0l0l0l0l0l0l0l0l0l0l0l0l0l0",
			"w1w1w1w1w1w1w1w1w1w1w1w1w1w1w1w1w1w1w1w1w1w1w1w1w1w1w1w1w1w1w1l1l1l1l1l1l1l1l1l1l1l1l1l1l1l1l1l1l1l1l1l1l1l1l1l1l1l1l1l1l1l1l1l1l1l1l1l1l1l1l1l1l1l1l0l0l0l0l0l0l0l0l0l0l0l0l0l0l0l0l0l0l0l0l0l0l0l0l0l0",
			"w1w1w1w1w1w1w1w1w1w1w1w1w1w1w1w1w1w1w1w1w1w1w1w1w1w1w1w1w1w1w1l1l1l1l1l1l1l1l1l1l1l1l1l1l1l1l1l1l1l1l1l1l1l1l1l1l1l1l1l1l1l1l1l1l1l1l1l1l1l1l1l1l1l1l0l0l0l0l0l0l0l0l0l0l0l0l0l0l0l0l0l0l0l0l0l0l0l0l0l0",
			"w1w1w1w1w1w1w1w1w1w1w1w1w1w1w1w1w1w1w1w1w1w1w1w1w1w1w1w1w1w1w1l1l1l1l1l1l1l1l1l1l1l1l1l1l1l1l1l1l1l1l1l1l1l1l1l1l1l1l1l1l1l1l1l1l1l1l1l1l1l1l1l1l1l1l0l0l0l0l0l0l0l0l0l0l0l0l0l0l0l0l0l0l0l0l0l0l0l0l0l0",
			"w1w1w1w1w1w1w1w1w1w1w1w1w1w1w1w1w1w1w1w1w1w1w1w1w1w1w1w1w1w1w1l1l1l1l1l1l1l1l1l1l1l1l1l1l1l1l1l1l1l1l1l1l1l1l1l1l1l1l1l1l1l1l1l1l1l1l1l1l1l1l1l1l1l1l0l0l0l0l0l0l0l0l0l0l0l0l0l0l0l0l0l0l0l0l0l0l0l0l0l0",
			"w1w1w1w1w1w1w1w1w1w1w1w1w1w1w1w1w1w1w1w1w1w1w1w1w1w1w1w1w1w1w1l1l1l1l1l1l1l1l1l1l1l1l1l1l1l1l1l1l1l1l1l1l1l1l1l1l1l1l1l1l1l1l1l1l1l1l1l1l1l1l1l1l1l1l0l0l0l0l0l0l0l0l0l0l0l0l0l0l0l0l0l0l0l0l0l0l0l0l0l0",
			"w1w1w1w1w1w1w1w1w1w1w1w1w1w1w1w1w1w1w1w1w1w1w1w1w1w1w1w1w1w1w1l1l1l1l1l1l1l1l1l1l1l1l1l1l1l1l1l1l1l1l1l1l1l1l1l1l1l1l1l1l1l1l1l1l1l1l1l1l1l1l1l1l1l1l0l0l0l0l0l0l0l0l0l0l0l0l0l0l0l0l0l0l0l0l0l0l0l0l0l0",
			"w1w1w1w1w1w1w1w1w1w1w1w1w1w1w1w1w1w1w1w1w1w1w1w1w1w1w1w1w1w1w1l1l1l1l1l1l1l1l1l1l1l1l1l1l1l1l1l1l1l1l1l1l1l1l1l1l1l1l1l1l1l1l1l1l1l1l1l1l1l1l1l1l1l1l0l0l0l0l0l0l0l0l0l0l0l0l0l0l0l0l0l0l0l0l0l0l0l0l0l0",
			"l0l0l0l0l0l0l0l0l0l0l0l0l0l0l0l0l0l0l0l0l0l0l0l0l0l0l0l0l0l0l0l1l1l1l1l1l1l1l1l1l1l1l1l1l1l1l1l1l1l1l1l1l1l1l1l1l1l1l1l1l1l1l1l1l1l1l1l1l1l1l1l1l1l1l0l0l0l0l0l0l0l0l0l0l0l0l0l0l0l0l0l0l0l0l0l0l0l0l0l0",
			"l0l0l0l0l0l0l0l0l0l0l0l0l0l0l0l0l0l0l0l0l0l0l0l0l0l0l0l0l0l0l0l1l1l1l1l1l1l1l1l1l1l1l1l1l1l1l1l1l1l1l1l1l1l1l1l1l1l1l1l1l1l1l1l1l1l1l1l1l1l1l1l1l1l1l0l0l0l0l0l0l0l0l0l0l0l0l0l0l0l0l0l0l0l0l0l0l0l0l0l0",
			"l0l0l0l0l0l0l0l0l0l0l0l0l0l0l0l0l0l0l0l0l0l0l0l0l0l0l0l0l0l0l0l1l1l1l1l1l1l1l1l1l1l1l1l1l1l1l1l1l1l1l1l1l1l1l1l1l1l1l1l1l1l1l1l1l1l1l1l1l1l1l1l1l1l1l0l0l0l0l0l0l0l0l0l0l0l0l0l0l0l0l0l0l0l0l0l0l0l0l0l0",
			"l0l0l0l0l0l0l0l0l0l0l0l0l0l0l0l0l0l0l0l0l0l0l0l0l0l0l0l0l0l0l0l1l1l1l1l1l1l1l1l1l1l1l1l1l1l1l1l1l1l1l1l1l1l1l1l1l1l1l1l1l1l1l1l1l1l1l1l1l1l1l1l1l1l1l0l0l0l0l0l0l0l0l0l0l0l0l0l0l0l0l0l0l0l0l0l0l0l0l0l0",
			"l0l0l0l0l0l0l0l0l0l0l0l0l0l0l0l0l0l0l0l0l0l0l0l0l0l0l0l0l0l0l0l1l1l1l1l1l1l1l1l1l1l1l1l1l1l1l1l1l1l1l1l1l1l1l1l1l1l1l1l1l1l1l1l1l1l1l1l1l1l1l1l1l1l1l0l0l0l0l0l0l0l0l0l0l0l0l0l0l0l0l0l0l0l0l0l0l0l0l0l0",
			"l0l0l0l0l0l0l0l0l0l0l0l0l0l0l0l0l0l0l0l0l0l0l0l0l0l0l0l0l0l0l0l1l1l1l1l1l1l1l1l1l1l1l1l1l1l1l1l1l1l1l1l1w0w0w0w0w0w0w0w0w0w0l3l3l3l3l3l3l3l3w0w0w0w0w0w0w0w0w0w0w0w0w0w0w0l0l0l0l0l0l0l0l0l0l0l0l0l0l0l0",
			"l0l0l0l0l0l0l0l0l0l0l0l0l0l0l0l0l0l0l0l0l0l0l0l0l0l0l0l0l0l0l0l1l1l1l1l1l1l1l1l1l1l1l1l1l1l1l1l1l1l1l1l1w0w0w0w0w0w0w0w0w0w0l3l3l3l3l3l3l3l3w0w0w0w0w0w0w0w0w0w0w0w0w0w0w0l0l0l0l0l0l0l0l0l0l0l0l0l0l0l0",
			"l0l0l0l0l0l0l0l0l0l0l0l0l0l0l0l0l0l0l0l0l0l0l0l0l0l0l0l0l0l0l0l1l1l1l1l1l1l1l1l1l1l1l1l1l1l1l1l1l1l1l1l1w0w0w0w0w0w0w0w0w0w0l3l3l3l3l3l3l3l3w0w0w0w0w0w0w0w0w0w0w0w0w0w0w0l0l0l0l0l0l0l0l0l0l0l0l0l0l0l0",
			"l0l0l0l0l0l0l0l0l0l0l0l0l0l0l0l0l0l0l0l0l0l0l0l0l0l0l0l0l0l0l0l1l1l1l1l1l1l1l1l1l1l1l1l1l1l1l1l1l1l1l1l1w0w0w0w0w0w0w0w0w0w0l3l3l3l3l3l3l3l3w0w0w0w0w0w0w0w0w0w0w0w0w0w0w0l0l0l0l0l0l0l0l0l0l0l0l0l0l0l0",
			"l0l0l0l0l0l0l0l0l0l0l0l0l0l0l0l0l0l0l0l0l0l0l0l0l0l0l0l0l0l0l0l1l1l1l1l1l1l1l1l1l1l1l1l1l1l1l1l1l1l1l1l1w0w0w0w0w0w0w0w0w0w0l3l3l3l3l3l3l3l3w0w0w0w0w0w0w0w0w0w0w0w0w0w0w0l0l0l0l0l0l0l0l0l0l0l0l0l0l0l0",
			"l0l0l0l0l0l0l0l0l0l0l0l0l0l0l0l0l0l0l0l0l2l2l2l2l2l2l2l2l2l2l2l2l2l2l2l2l2l2l2l2l2l2l0l0l0l0l0l0l0l0l0l0w0w0w0w0w0w0w0w0w0w0l3l3l3l3l3l3l3l3w0w0w0w0w0w0w0w0w0w0w0w0w0w0w0l0l0l0l0l0l0l0l0l0l0l0l0l0l0l0",
			"l0l0l0l0l0l0l0l0l0l0l0l0l0l0l0l0l0l0l0l0l2l2l2l2l2l2l2l2l2l2l2l2l2l2l2l2l2l2l2l2l2l2l0l0l0l0l0l0l0l0l0l0w0w0w0w0w0w0w0w0w0w0l3l3l3l3l3l3l3l3w0w0w0w0w0w0w0w0w0w0w0w0w0w0w0l0l0l0l0l0l0l0l0l0l0l0l0l0l0l0",
			"l0l0l0l0l0l0l0l0l0l0l0l0l0l0l0l0l0l0l0l0l2l2l2l2l2l2l2l2l2l2l2l2l2l2l2l2l2l2l2l2l2l2l0l0l0l0l0l0l0l0l0l0w0w0w0w0w0w0w0w0w0w0l3l3l3l3l3l3l3l3l3l3l3l3l3l3l3l3w0w0w0w0w0w0w0l0l0l0l0l0l0l0l0l0l0l0l0l0l0l0",
			"l0l0l0l0l0l0l0l0l0l0l0l0l0l0l0l0l0l0l0l0l2l2l2l2l2l2l2l2l2l2l2l2l2l2l2l2l2l2l2l2l2l2l0l0l0l0l0l0l0l0l0l0w0w0w0w0w0w0w0w0w0w0l3l3l3l3l3l3l3l3l3l3l3l3l3l3l3l3w0w0w0w0w0w0w0l0l0l0l0l0l0l0l0l0l0l0l0l0l0l0",
			"l0l0l0l0l0l0l0l0l0l0l0l0l0l0l0l0l0l0l0l0l2l2l2l2l2l2l2l2l2l2l2l2l2l2l2l2l2l2l2l2l2l2l0l0l0l0l0l0l0l0l0l0w0w0w0w0w0w0w0w0w0w0l3l3l3l3l3l3l3l3l3l3l3l3l3l3l3l3w0w0w0w0w0w0w0l0l0l0l0l0l0l0l0l0l0l0l0l0l0l0",
			"l0l0l0l0l0l0l0l0l0l0l0l0l0l0l0l0l0l0l0l0l2l2l2l2l2l2l2l2l2l2l2l2l2l2l2l2l2l2l2l2l2l2l0l0l0l0l0l0l0l0l0l0w0w0w0w0w0w0w0w0w0w0l3l3l3l3l3l3l3l3l3l3l3l3l3l3l3l3w0w0w0w0w0w0w0l0l0l0l0l0l0l0l0l0l0l0l0l0l0l0",
			"l0l0l0l0l0l0l0l0l0l0l0l0l0l0l0l0l0l0l0l0l2l2l2l2l2l2l2l2l2l2l2l2l2l2l2l2l2l2l2l2l2l2l0l0l0l0l0l0l0l0l0l0w0w0w0w0w0w0w0w0w0w0l3l3l3l3l3l3l3l3l3l3l3l3l3l3l3l3w0w0w0w0w0w0w0l0l0l0l0l0l0l0l0l0l0l0l0l0l0l0",
			"l0l0l0l0l0l0l0l0l0l0l0l0l0l0l0l0l0l0l0l0l2l2l2l2l2l2l2l2l2l2l2l2l2l2l2l2l2l2l2l2l2l2l0l0l0l0l0l0l0l0l0l0w0w0w0w0w0w0w0w0w0w0l3l3l3l3l3l3l3l3l3l3l3l3l3l3l3l3w0w0w0w0w0w0w0l0l0l0l0l0l0l0l0l0l0l0l0l0l0l0",
			"l0l0l0l0l0l0l0l0l0l0l0l0l0l0l0l0l0l0l0l0l2l2l2l2l2l2l2l2l2l2l2l2l2l2l2l2l2l2l2l2l2l2l0l0l0l0l0l0l0l0l0l0w0w0w0w0w0w0w0w0w0w0l3l3l3l3l3l3l3l3l3l3l3l3l3l3l3l3w0w0w0w0w0w0w0l0l0l0l0l0l0l0l0l0l0l0l0l0l0l0",
			"l0l0l0l0l0l0l0l0l0l0l0l0l0l0l0l0l0l0l0l0l2l2l2l2l2l2l2l2l2l2l2l2l2l2l2l2l2l2l2l2l2l2l0l0l0l0l0l0l0l0l0l0w0w0w0w0w0w0w0w0w0w0l3l3l3l3l3l3l3l3l3l3l3l3l3l3l3l3w0w0w0w0w0w0w0l0l0l0l3l3l3w1w1w1w1l0l0l0l0l0",
			"l0l0l0l0l0l0l0l0l0l0l0l0l0l0l0l0l0l0l0l0l2l2l2l2l2l2l2l2l2l2l2l2l2l2l2l2l2l2l2l2l2l2l0l0l0l0l0l0l0l0l0l0w0w0w0w0w0w0w0w0w0w0l3l3l3l3l3l3l3l3l3l3l3l3l3l3l3l3w0w0w0w0w0w0w0l0l0l0l3l3l3w1w1w1w1l0l0l0l0l0",
			"l0l0l0l0l0l0l0l0l0l0l0l0l0l0l0l0l0l0l0l0l2l2l2l2l2l2l2l2l2l2l2l2l2l2l2l2l2l2l2l2l2l2l0l0l0l0l0l0l0l0l0l0w0w0w0w0w0w0w0w0w0w0l3l3l3l3l3l3l3l3l3l3l3l3l3l3l3l3w0w0w0w0w0w0w0l0l0l0l3l3l3w1w1w1w1l0l0l0l0l0",
			"l0l0l0l0l0l0l0l0l0l0l0l0l0l0l0l0l0l0l0l0l2l2l2l2l2l2l2l2l2l2l2l2l2l2l2l2l2l2l2l2l2l2l0l0l0l0l0l0l0l0l0l0w0w0w0w0w0w0w0w0w0w0w0w0w0l3l3l3l3l3l3l3l3l3l3l3l3l3w0w0w0w0w0w0w0l0l0l0l3l3l3w1w1w1w1l0l0l0l0l0",
			"l0l0l0l0l0l0l0l0l0l0l0l0l0l0l0l0l0l0l0l0l2l2l2l2l2l2l2l2l2l2l2l2l2l2l2l2l2l2l2l2l2l2l0l0l0l0l0l0l0l0l0l0w0w0w0w0w0w0w0w0w0w0w0w0w0l3l3l3l3l3l3l3l3l3l3l3l3l3w0w0w0w0w0w0w0l0l0l0l3l3l3w1w1w1w1l0l0l0l0l0",
			"l0l0l0l0l0l0l0l0l0l0l0l0l0l0l0l0l0l0l0l0l2l2l2l2l2l2l2l2l2l2l2l2l2l2l2l2l2l2l2l2l2l2l0l0l0l0l0l0l0l0l0l0w0w0w0w0w0w0w0w0w0w0w0w0w0l3l3l3l3l3l3l3l3l3l3l3l3l3w0w0w0w0w0w0w0l0l0l0l3l3l3w1w1w1w1l0l0l0l0l0",
			"l0l0l0l0l0l0l0l0l0l0l0l0l0l0l0l0l0l0l0l0l2l2l2l2l2l2l2l2l2l2l2l2l2l2l2l2l2l2l2l2l2l2l0l0l0l0l0l0l0l0l0l0w0w0w0w0w0w0w0w0w0w0w0w0w0l3l3l3l3l3l3l3l3l3l3l3l3l3w0w0w0w0w0w0w0l0l0l0l3l3l3w1w1w1w1l0l0l0l0l0",
			"l0l0l0l0l0l0l0l0l0l0l0l0l0l0l0l0l0l0l0l0l2l2l2l2l2l2l2l2l2l2l2l2l2l2l2l2l2l2l2l2l2l2l0l0l0l0l0l0l0l0l0l0w0w0w0w0w0w0w0w0w0w0w0w0w0l3l3l3l3l3l3l3l3l3l3l3l3l3w0w0w0w0w0w0w0l0l0l0l3l3l3w1w1w1w1l0l0l0l0l0",
			"l0l0l0l0l0l0l0l0l0l0l0l0l0l0l0l0l0l0l0l0l2l2l2l2l2l2l2l2l2l2l2l2l2l2l2l2l2l2l2l2l2l2l0l0l0l0l0l0l0l0l0l0w0w0w0w0w0w0w0w0w0w0w0w0w0l3l3l3l3l3l3l3l3l3l3l3l3l3w0w0w0w0w0w0w0l0l0l0l3l3l3w1w1w1w1l0l0l0l0l0",
			"l0l0l0l0l0l0l0l0l0l0l0l0l0l0l0l0l0l0l0l0l2l2l2l2l2l2l2l2l2l2l2l2l2l2l2l2l2l2l2l2l2l2l0l0l0l0l0l0l0l0l0l0w0w0w0w0w0w0w0w0w0w0w0w0w0l3l3l3l3l3l3l3l3l3l3l3l3l3w0w0w0w0w0w0w0l0l0l0l3l3l3w1w1w1w1l0l0l0l0l0",
			"l0l0l0l0l0l0l0l0l0l0l0l0l0l0l0l0l0l0l0l0l2l2l2l2l2l2l2l2l2l2l2l2l2l2l2l2l2l2l2l2l2l2l0l0l0l0l0l0l0l0l0l0w0w0w0w0w0w0w0w0w0w0w0w0w0w0w0w0w0w0w0w0w0w0w0w0w0w0w0w0w0w0w0w0w0l0l0l0l3l3l3w1w1w1w1l0l0l0l0l0",
			"l0l0l0l0l0l0l0l0l0l0l0l0l0l0l0l0l0l0l0l0l0l0l0l0l0l0l0l0l0l0l0l0l0l0l0l0l0l0l0l0l0l0l0l0l0l0l0l0l0l0l0l0w0w0w0w0w0w0w0w0w0w0w0w0w0w0w0w0w0w0w0w0w0w0w0w0w0w0w0w0w0w0w0w0w0l0l0l0l3l3l3w1w1w1w1l0l0l0l0l0",
			"l0l0l0l0l0l0l0l0l0l0l0l0l0l0l0l0l0l0l0l0l0l0l0l0l0l0l0l0l0l0l0l0l0l0l0l0l0l0l0l0l0l0l0l0l0l0l0l0l0l0l0l0w0w0w0w0w0w0w0w0w0w0w0w0w0w0w0w0w0w0w0w0w0w0w0w0w0w0w0w0w0w0w0w0w0l0l0l0l3l3l3w1w1w1w1l0l0l0l0l0",
			"l0l0l0l0l0l0l0l0l0l0l0l0l0l0l0l0l0l0l0l0l0l0l0l0l0l0l0l0l0l0l0l0l0l0l0l0l0l0l0l0l0l0l0l0l0l0l0l0l0l0l0l0w0w0w0w0w0w0w0w0w0w0w0w0w0w0w0w0w0w0w0w0w0w0w0w0w0w0w0w0w0w0w0w0w0l0l0l0l3l3l3w1w1w1w1l0l0l0l0l0",
			"l0l0l0l0l0l0l0l0l0l0l0l0l0l0l0l0l0l0l0l0l0l0l0l0l0l0l0l0l0l0l0l0l0l0l0l0l0l0l0l0l0l0l0l0l0l0l0l0l0l0l0l0w0w0w0w0w0w0w0w0w0w0w0w0w0w0w0w0w0w0w0w0w0w0w0w0w0w0w0w0w0w0w0w0w0l0l0l0l3l3l3w1w1w1w1l0l0l0l0l0",
			"l0l0l0l0l0l0l0l0l0l0l0l0l0l0l0l0l0l0l0l0l0l0l0l0l0l0l0l0l0l0l0l0l0l0l0l0l0l0l0l0l0l0l0l0l0l0l0l0l0l0l0l0w0w0w0w0w0w0w0w0w0w0w0w0w0w0w0w0w0w0w0w0w0w0w0w0w0w0w0w0w0w0w0w0w0l0l0l0l3l3l3w1w1w1w1l0l0l0l0l0",
			"l0l0l0l0l0l0l0l0l0l0l0l0l0l0l0l0l0l0l0l0l0l0l0l0l0l0l0l0l0l0l0l0l0l0l0l0l0l0l0l0l0l0l0l0l0l0l0l0l0l0l0l0w0w0w0w0w0w0w0w0w0w0w0w0w0w0w0w0w0w0w0w0w0w0w0w0w0w0w0w0w0w0w0w0w0l0l0l0l3l3l3w1w1w1w1l0l0l0l0l0",
			"l0l0l0l0l0l0l0l0l0l0l0l0l0l0l0l0l0l0l0l0l0l0l0l0l0l0l0l0l0l0l0l0l0l0l0l0l0l0l0l0l0l0l0l0l0l0l0l0l0l0l0l0w0w0w0w0w0w0w0w0w0w0w0w0w0w0w0w0w0w0w0w0w0w0w0w0w0w0w0w0w0w0w0w0w0l0l0l0l3l3l3w1w1w1w1l0l0l0l0l0",
			"l0l0l0l0l0l0l0l0l0l0l0l0l0l0l0l0l0l0l0l0l0l0l0l0l0l0l0l0l0l0l0l0l0l0l0l0l0l0l0l0l0l0l0l0l0l0l0l0l0l0l0l0w0w0w0w0w0w0w0w0w0w0w0w0w0w0w0w0w0w0w0w0w0w0w0w0w0w0w0w0w0w0w0w0w0l0l0l0l3l3l3w1w1w1w1l0l0l0l0l0",
			"l0l0l0l0l0l0l0l0l0l0l0l0l0l0l0l0l0l0l0l0l0l0l0l0l0l0l0l0l0l0l0l0l0l0l0l0l0l0l0l0l0l0l0l0l0l0l0l0l0l0l0l0w1w1w1w1w1w1w1w1w1w1w1w1w1w1w1w1w1w1w1w1w1w1w1w1w1w1w1w1w1w1w1w1w1w1w1w1w1w1w1w1w1w1w1w1w1w1w1w1",
			"l0l0l0l0l0l0l0l0l0l0l0l0l0l0l0l0l0l0l0l0l0l0l0l0l0l0l0l0l0l0l0l0l0l0l0l0l0l0l0l0l0l0l0l0l0l0l0l0l0l0l0l0w1w1w1w1w1w1w1w1w1w1w1w1w1w1w1w1w1w1w1w1w1w1w1w1w1w1w1w1w1w1w1w1w1w1w1w1w1w1w1w1w1w1w1w1w1w1w1w1",
			"l0l0l0l0l0l0l0l0l0l0l0l0l0l0l0l0l0l0l0l0l0l0l0l0l0l0l0l0l0l0l0l0l0l0l0l0l0l0l0l0l0l0l0l0l0l0l0l0l0l0l0l0w1w1w1w1w1w1w1w1w1w1w1w1w1w1w1w1w1w1w1w1w1w1w1w1w1w1w1w1w1w1w1w1w1w1w1w1w1w1w1w1w1w1w1w1w1w1w1w1",
			"l0l0l0l0l0l0l0l0l0l0l0l0l0l0l0l0l0l0l0l0l0l0l0l0l0l0l0l0l0l0l0l0l0l0l0l0l0l0l0l0l0l0l0l0l0l0l0l0l0l0l0l0w1w1w1w1w1w1w1w1w1w1w1w1w1w1w1w1w1w1w1w1w1w1w1w1w1w1w1w1w1w1w1w1w1w1w1w1w1w1w1w1w1w1w1w1w1w1w1w1",
			"l0l0l0l0l0l0l0l0l0l0l0l0l0l0l0l0l0l0l0l0l0l0l0l0l0l0l0l0l0l0l0l0l0l0l0l0l0l0l0l0l0l0l0l0l0l0l0l0l0l0l0l0w1w1w1w1w1w1w1w1w1w1w1w1w1w1w1w1w1w1w1w1w1w1w1w1w1w1w1w1w1w1w1w1w1w1w1w1w1w1w1w1w1w1w1w1w1w1w1w1",
			"l0l0l0l0l0l0l0l0l0l0l0l0l0l0l0l0l0l0l0l0l0l0l0l0l0l0l0l0l0l0l0l0l0l0l0l0l0l0l0l0l0l0l0l0l0l0l0l0l0l0l0l0w1w1w1w1w1w1w1w1w1w1w1w1w1w1w1w1w1w1w1w1w1w1w1w1w1w1w1w1w1w1w1w1w1w1w1w1w1w1w1w1w1w1w1w1w1w1w1w1",
			"l0l0l0l0l0l0l0l0l0l0l0l0l0l0l0l0l0l0l0l0l0l0l0l0l0l0l0l0l0l0l0l0l0l0l0l0l0l0l0l0l0l0l0l0l0l0l0l0l0l0l0l0w1w1w1w1w1w1w1w1w1w1w1w1w1w1w1w1w1w1w1w1w1w1w1w1w1w1w1w1w1w1w1w1w1w1w1w1w1w1w1w1w1w1w1w1w1w1w1w1",
		]
}
